a   7   z   z   t   2   f   x   m   r   a   3
a   b   o   q   y   t   j   S   w   l   n   k
f   L   5   u   J   1   D   s   v   B   R   i
E   F   G   Z   X   h   M   Y   K   C   Q   N
Y   2   o   w   F   S   l   R   J   7   I   t
e   a   t   f   z   v   I   m   k   w   n   b
H   6   f   Y   9   O   j   Z   L   5   q   s
K   V   K   D   E   I   e   T   R   S   X   C
m   Q   7   o   P   5   F   j   A   Y   3   K
d   L   e   b   x   n   d   w   o   j   i   r
9   T   m   Y   v   3   S   f   K   r   8   J
q   a   j   b   h   g   z   y   l   p   f   D